vuln    vulnerability
abbrev 	abbreviation 
Abbrev 	abbreviation
Abd 	Aberdeen
Aberd 	Aberdeen
Aberdeensh 	Aberdeenshire
abl 	ablative
Abol 	abolition
Aborig 	aboriginal
Abp 	archbishop
Abr 	abridged
Abridg 	abridged
Abridgem 	abridgement
absol 	absolute
Absol 	absolute
Abst 	abstract
abstr 	abstract
Abstr 	abstract
Acad 	academia
acc 	according 
acc 	accusative
Acc 	account
Accept 	acceptance
Accomm 	accommodation
Accompl 	accomplished
Accs 	accounts
Acct 	account
Accts 	accounts
accus 	accusative
Achievem 	achievement
AD 	Anno Domini
ad 	adaptation of
Add 	addendum
Addit 	addition
Addr 	address
adj 	adjective
adjs 	adjectives
Adm 	admiral
Adm 	admiralty
Admin 	administration
Admir 	admiralty
Admon 	admonition
Admonit 	admonition
adv 	adverb
Adv 	advanced
Adv 	advances
Adv 	adventure
Adv 	advices
Adv 	advocate
Advancem 	advancement
advb 	adverb
Advert 	advertisement
Advoc 	advocate
advs 	adverbs
Advt 	advertisement
Advts 	advertisements
Aerodynam 	aerodynamics
Aeronaut 	aeronautics
Aff 	affairs
Affect 	affecting
Affect 	affection
Afr 	Africa
Agric 	agriculture
agst 	against
Alch 	alchemy
Alg 	algebra
Alleg 	allegiance
Allit 	alliterative
Alm 	almanac
Alph 	alphabet
alt 	alteration
Amer 	America
Anal 	analysis
Analyt 	analytic
Anat 	anatomy
Anc 	ancient
Anecd 	anecdotes
Ang 	Anglian
Angl 	Anglian
Anglo-Ind 	Anglo-Indian
Anim 	animal
Ann 	annal
Ann 	annual
Anniv 	anniversary
Annot 	annotation
Anon 	 Anonymous
Answ 	answer
Ant 	antiquities
Anthrop 	anthropology
Anthropol 	anthropology
Antiq 	antiquity
aphet 	aphetic
Apoc 	apocalyptic
Apol 	apology
app 	apparently
App 	appendix
Appl 	applied
Applic 	application
appos 	appositive
Apr 	April
Arab 	Arabic
Arb 	 Arber
arch 	archaic
Arch 	architecture
Arch 	archive
Archaeol 	archaeology
Archipel 	archipelago
Archit 	architecture
Argt 	argument
Arith 	arithmetic
Arithm 	arithmetic
Arrangem 	arrangement
art 	article
Artic 	articulation
Artific 	artificial
Artill 	artillery
Ashm 	 Ashmole
Assemb 	assembly
Assoc 	association
Assyriol 	Assyriology
Astr 	astronomy
Astrol 	astrology
Astron 	astronomy
Astronaut 	astronautics
Att 	Attic
attrib 	attributive
Attrib 	attribute
Aug 	August
Austral 	Australia
Auth 	author
Autobiog 	autobiography
Autobiogr 	autobiography
AV 	Authorized Version
Ayrsh 	Ayrshire  
Bacteriol 	bacteriology
Bedford 	Bedfordshire
Bedfordsh 	Bedfordshire
bef 	before
Belg 	Belgian
Berks 	Berkshire
Berksh 	Berkshire
Berw 	Berwickshire
Berwicksh 	Berwickshire
betw 	between
Bibliogr 	bibliography
Biochem 	biochemistry
Biog 	biography
Biogr 	biography
Biol 	biology
Bk 	book
Bks 	books
BNC 	British National Corpus
Bord 	border
Bot 	botany
Bp 	Bishop
Braz 	Brazilian
Brit 	Britain
Bucks 	Buckinghamshire
Build 	building
Bull 	bulletin
Bur 	bureau
c 	century
C 	county
c 	 circa
Cal 	calendar
Calc 	calculus
Calend 	calendar
Calif 	California
Calligr 	calligraphy
Camb 	Cambridge
Cambr 	Cambridge
Campanol 	campanology
Canad 	Canadian
Canterb 	Canterbury
Capt 	captain
Cartogr 	cartography
Catal 	catalogue
Catech 	catechism
Cath 	Catholic
cent 	century
Cent 	central
Cent 	century
Ceram 	ceramics
Cert 	certificate
Certif 	certificate
Ch 	Church
Chamb 	chamber
Char 	character
Charac 	character
Chas 	Charles
Chem 	chemistry
Chesh 	Cheshire
Chr 	Christian
Chr 	 Chronicles
Chron 	chronology
Chron 	 Chronicles
Chronol 	chronology
Chrons 	chronicles
Cinematogr 	cinematography
Circ 	circle
cl 	clause
Cl 	club
Class 	classical
Classif 	classification
Climatol 	climatology
Clin 	clinical
Col 	colonel
Col 	 Colossians
Coll 	collected
Coll 	college
collect 	collective
Collect 	collection
colloq 	colloquial
Colloq 	colloquies
Coloss 	 Colossians
Com 	common
Com 	commission
Comb 	combination
Combs 	combinations
Comm 	commerce
Comm 	common
Comm 	commentary
Comm 	commission
Comm 	committee
Commandm 	commandment
Commend 	commendation
Commerc 	commercial
Commiss 	commission
Comm Law 	commercial law
Commonw 	commonwealth
Communic 	communication
comp 	comparative
comp 	compound
Comp 	companion
Comp 	company
Compan 	companion
compar 	comparative
Compar 	comparative
Compend 	compendium
compl 	complement
Compl 	complete
Compos 	composition
conc 	concerning
Conc 	concise
Conch 	conchology
Concl 	conclusion
concr 	concrete
Conf 	conference
Conf 	confession
Confid 	confidential
Confl 	conflict
Confut 	confutation
Congr 	congress
Congreg 	congregation
Congress 	congressional
conj 	conjugation
conj 	conjunction
Conn 	Connecticut
cons 	consonant
Consc 	conscience
Consecr 	consecrated
Consid 	consideration
Consol 	consolation
const 	construction
Constit 	constitution
Constr 	construction
Contemp 	contemporary
Contempl 	contemplation
contempt 	contemptuous
Contend 	contending
Content 	contention
Contin 	continuation
contr 	contracted
contr 	contrasted 
Contradict 	contradiction
Contrib 	contribution
Controv 	controversial
Controv 	controversy
Conv 	convention
Convent 	convention
Conversat 	conversation
Convoc 	convocation
Cor 	 Corinthians
Cornw 	Cornwall
Coron 	coronation
Corr 	correspondence
corresp 	corresponding 
Corresp 	correspondence
Counc 	council
Courtsh 	courtship
cpd 	compound
Craniol 	craniology
Craniom 	craniometry
Crim 	criminal
Crim Law 	criminal law
Crit 	critical
Crit 	criticism
Crt 	court
Crts 	courts
Cryptogr 	cryptography
Crystallogr 	crystallography
Ct 	count
Ct 	court
Cumb 	Cumberland
Cumberld 	Cumberland
Cumbld 	Cumberland
Cycl 	cyclopaedia
Cytol 	cytology
Dan 	 Daniel
dat 	dative
Dau 	daughter
Deb 	debate
Dec 	December
Declar 	declaration
Ded 	dedicated
Ded 	dedication
def 	definite
def 	definition
Def 	defence
Deliv 	deliverance
dem 	demonstrative
Demonstr 	demonstration
Dep 	department
Dep 	deputy
Depred 	depredation
Depredat 	depredation
Dept 	department
Derbysh 	Derbyshire
deriv 	derivative 
derog 	derogatory
Descr 	description
Deut 	 Deuteronomy
Devel 	development
Devonsh 	Devonshire
dial 	dialect
Dial 	dialect
Dict 	dictionary
Diffic 	difficult
dim 	diminutive
Direct 	direction
Dis 	disease
Disc 	discourse
Discipl 	discipline
Discov 	discovery
Discrim 	discrimination
Discuss 	discussion
Diss 	dissertation
Dist 	district
Distemp 	distemper
Distill 	distilling
Distrib 	distribution
Div 	divinity
Div 	division
Divers 	diversity
Dk 	Duke
Doc 	document
Doctr 	doctrine
Domest 	domestic
Durh 	Durham
dyslog 	dyslogistic
E Anglian 	East Anglian
East Ind 	East Indies
east 	eastern 
Eccl 	ecclesiastical
Eccl 	 Ecclesiastes
Eccles 	ecclesiastical
Eccles 	 Ecclesiastes
Ecclus 	 Ecclesiasticus
Ecol 	ecology
Econ 	economics
ed 	edition
Ed 	edition
Ed 	Edward
Edin 	Edinburgh
Edinb 	Edinburgh
Educ 	education
Edw 	Edward
Egypt 	Egyptian
Egyptol 	Egyptology
E Ind 	East Indies
Electr 	electricity
Electro-magn 	electro-magnetism
Electro-physiol 	electro-physiology
Elem 	element
Eliz 	Elizabeth
Elizab 	Elizabethan
ellipt 	elliptical
Emb 	embassy
Embryol 	embryology
e midl 	east midland 
emph 	emphatic
Encycl 	encyclopaedia
Eng 	England
Engin 	engineering
Englishw 	Englishwomen
Enq 	enquiry
Ent 	entomology
Enthus 	enthusiasm
Entom 	entomology
Entomol 	entomology
Enzymol 	enzymology
Ep 	epistle
Eph 	 Ephesians
Ephes 	 Ephesians
Epil 	epilogue
Episc 	episcopacy
Epist 	epistle
Epit 	epitaph
Equip 	equipment
erron 	erroneous
Esd 	 Esdras
esp 	especially
Ess 	essay
Essent 	essential
Establ 	establishment
Esth 	 Esther
Ethnol 	ethnology
etym 	etymology
etymol 	etymological
Etymol 	etymology
euphem 	euphemistic
Eval 	evaluation
Evang 	evangelical
Even 	evening
Evid 	evidence
Evol 	evolution
Ex doc 	executive document
Exalt 	exaltation
Exam 	examination
exc 	except
Exch 	exchange
Exch 	exchequer
Exec 	execution
Exec 	executive
Exerc 	exercise
Exhib 	exhibition
Exod 	 Exodus
Exped 	expedition
Exper 	experiment
Explan 	explanation
Explic 	explication
Explor 	exploration
Expos 	exposition
Ezek 	 Ezekiel
f 	feminine
f 	folio
Fab 	fable
fam 	familiar
Fam 	family
famil 	familiar
Farew 	farewell
Feb 	February
fem 	feminine
Ff 	folios
Fifesh 	Fifeshire
fig 	figurative
Footpr 	footprint
Forfarsh 	Forfarshire
Fortif 	fortification
Fortn 	fortnightly
Found 	foundation
Fr 	father
Fr 	French
Fr 	from
Fragm 	fragment
Fratern 	fraternity
freq 	frequently
Friendsh 	friendship
Fund 	fundamental
Furnit 	furniture
fut 	future
Gal 	 Galatians
Gard 	garden
Gastron 	gastronomy
Gaz 	gazette
Gd 	good
gen 	general
gen 	genitive
Gen 	general
Gen 	 Genesis
Geo 	George
Geog 	geography
Geogr 	geography
Geol 	geology
Geom 	geometry
Geomorphol 	geomorphology
Ger 	German
gerund 	gerundial
Glac 	glacier
Glasg 	Glasgow
Glos 	Gloucestershire
Gloss 	glossary
Glouc 	Gloucestershire
Gloucestersh 	Gloucestershire
Gosp 	gospel
Gov 	government
Govt 	government
Gr 	grammar
Gram 	grammar
Gt 	great
Gynaecol 	gynaecology
Hab 	 Habakkuk
Haematol 	haematology
Hag 	 Haggai
Hampsh 	Hampshire
Handbk 	handbook
Hants 	Hampshire
Heb 	Hebrew
Heb 	 Hebrews
Hebr 	 Hebrews
Hen 	Henry
Her 	heraldry
Herb 	herbalism
Heref 	Herefordshire
Hereford 	Herefordshire
Herefordsh 	Herefordshire
Hertfordsh 	Hertfordshire
Hierogl 	Hieroglyphic
hist 	historical
Hist 	history
Histol 	histology
Hom 	homilies
Horol 	horology
Hort 	horticulture
Hos 	 Hosea
Hosp 	hospital
Househ 	household
Housek 	housekeeping
Husb 	husbandry
Hydraul 	hydraulic
Hydrol 	hydrology
Ichth 	ichthyology
Icthyol 	icthyology
Ideol 	ideology
Idol 	idolatry
Illustr 	illustrated
Imag 	imaginary
imit 	imitative
Immunol 	immunology
imp 	imperative
imperf 	imperfect
impers 	impersonal
impf 	imperfect
Impr 	impression
Impr 	imprint
Impr 	improved
improp 	improper
Inaug 	inaugural
Inclos 	inclosure
Ind 	India
ind 	indicative
ind 	indirect
Ind 	industry
indef 	indefinite
indic 	indicative
indir 	indirect
Industr 	industrial
infin 	infinitive
infl 	influenced
Infl 	influence
Innoc 	innocence
Inorg 	inorganic
Inq 	inquiry
Inst 	institute
instr 	instrumental
Instr 	instruction
int 	interjection
Intell 	intelligence
Intellect 	intellectual
Interc 	intercourse
interj 	interjection
Interl 	interlude
Internat 	international
Interpr 	interpretation
interrog 	interrogative
intr 	intransitive
intrans 	intransitive
Intro 	introduction
Introd 	introduction
Inv 	inventory
Invent 	invention
Invent 	inventory
Invertebr 	invertebrate
Investig 	investigation
Investm 	investment
Invoc 	invocation
Ir 	Irish
Irel 	Ireland
iron 	ironically
irreg 	irregular
Isa 	 Isaiah
Ital 	Italian
Jahrb 	Jahrbuch
Jam 	 James
Jam 	 Jamieson
Jan 	January
Jap 	Japanese
Jas 	James
Jas 	 James
Jer 	 Jeremiah
joc 	jocular
Josh 	 Joshua
Jrnl 	journal
Jrnls 	journals
Jud 	 Judges
Judg 	 Judges
Jul 	July
Jun 	June
Jun 	junior
Jurisd 	jurisdiction
Jurisdict 	jurisdiction
Jurispr 	jurisprudence
Justif 	justification
Justific 	justification
K 	king
Kent 	Kentish
Kgs 	 Kings
Kingd 	kingdom
Knowl 	knowledge
Kpr 	keeper
l 	line
Lab 	laboratory
Lam 	 Lamentations
Lament 	lamentation
Lament 	 Lamentations
Lanc 	Lancashire
Lancash 	Lancashire
Lancs 	Lancashire
Lang 	language
Langs 	languages
Lat 	Latin
Ld 	Lord
Lds 	Lords
Lect 	lecture
Leechd 	leechdom
Leg 	legend
Leicest 	Leicestershire
Leicester 	Leicestershire
Leicestersh 	Leicestershire
Leics 	Leicestershire
Let 	letter
Lett 	letters
Lev 	 Leviticus
Lex 	lexicon
Libr 	library
Limnol 	limnology
Lincolnsh 	Lincolnshire
Lincs 	Lincolnshire
Ling 	linguistic
Linn 	Linnean
lit 	literal
Lit 	literary
Lithogr 	lithography
Lithol 	lithology
Liturg 	liturgy
ll 	lines
Lond 	London
LXX 	Septuagint
m 	masculine
Macc 	 Maccabees
Mach 	machinery
Mag 	magazine
Magn 	magnetism
Mal 	 Malachi
Man 	manual
Managem 	management
Manch 	Manchester
Manip 	manipulation
Manuf 	manufacturing
Mar 	March
masc 	masculine
Mass 	Massachussets
Math 	mathematics
Matt 	 Matthew
Meas 	measure
Measurem 	measurement
Mech 	mechanics
med 	medieval
Med 	medicine
Medit 	meditation
Mem 	memoir
Merc 	mercury
Merch 	merchant
Metall 	metallurgy
Metallif 	metalliferous
Metallogr 	metallography
Metallogr 	metallography
Metamorph 	metamorphosis
Metaph 	metaphysics
metaphor 	metaphorical
Meteorol 	meteorology
Meth 	method
metr gr 	metri gratia
Metrop 	metropolitan
Mex 	Mexican
Mic 	 Micah
Mich 	Michigan
Microbiol 	microbiology
Microsc 	microscopic
midl 	midland 
Mil 	military
Milit 	military
Min 	mineralogy
Mineral 	mineralogy
Misc 	miscellaneous
Miscell 	miscellany
mispr 	misprinted
mod 	modern
Mod 	modern
Monum 	monument
Morphol 	morphology
MS 	manuscript
MSS 	manuscripts
Mt 	mount
Mtg 	meeting
Mts 	mountains
Munic 	municipal
Munif 	munificence
Munim 	muniment
Mus 	music
Mus 	museum
Myst 	mystery
Myth 	mythology
Mythol 	mythology
n 	neuter
n 	north
n 	noun
N 	north
Nah 	 Nahum
Narr 	narrative
Narrat 	narrative
Nat 	natural
Naut 	nautical
Nav 	naval
Nav 	navigation
Navig 	navigation
ne 	north-eastern 
NE 	north-east
NED 	New English Dictionary
Neh 	 Nehemiah
Neighb 	neighbour
Nerv 	nervous
Neurol 	neurology
Neurosurg 	neurosurgery
New Hampsh 	New Hampshire
Newc 	Newcastle
Newspr 	newsprint
No 	number
nom 	nominative
Non-conf 	nonconformist
nonce-wd 	nonce-word
Nonconf 	nonconformist
Norf 	Norfolk
north 	northern 
Northamptonsh 	Northamptonshire
Northants 	Northamptonshire
Northumb 	Northumberland
Northumbld 	Northumberland
Northumbr 	Northumbrian
Norw 	Norwegian
Norweg 	Norwegian
Notts 	Nottinghamshire
Nov 	November
ns 	nouns
NS Wales 	New South Wales
NSW 	New South Wales
NT 	New Testament
Nucl 	nuclear
Num 	 Numbers
Numism 	numismatics
nw 	north-western 
NW 	north-west
NY 	New York
NZ 	New Zealand
Obad 	 Obadiah
Obed 	obedience
obj 	object
Obj 	object
obl 	oblique
obs 	obsolete
Obs 	obsolete
Observ 	observation
Obstet 	obstetric
Obstetr 	obstetric
Obstetr Med 	obstetric medicine
occas 	occasionally
Occas 	occasional
Occup 	occupation
Occurr 	occurrence
Oceanogr 	oceanography
Oct 	October
OE 	 Old English
Off 	official
Offic 	official
Okla 	Oklahoma
Ont 	Ontario
Ophthalm 	ophthalmology
Ophthalmol 	ophthalmology
opp 	opposed 
Oppress 	oppression
Opt 	optics
Orac 	oracle
Ord 	order
Ord 	ordinance
Org 	organic
orig 	origin
Orig 	original
Orkn 	Orkney
Ornith 	ornithology
Ornithol 	ornithology
Orthogr 	orthography
OT 	Old Testament
Outl 	outline
Oxf 	Oxford
Oxfordsh 	Oxfordshire
Oxon 	Oxfordshire
p 	page
pa 	past
Pa 	Pennsylvania
Palaeobot 	palaeobotany
Palaeogr 	palaeography
Palaeont 	palaeontology
Palaeontol 	palaeontology
pa pple 	passive participle
Paraphr 	paraphrase
Parasitol 	parasitology
Parl 	parliament
Parnass 	Parnassus
pass 	passive
pa t 	past tense
Path 	pathology
Pathol 	pathology
Peculat 	peculation
Penins 	peninsula
perf 	perfect
Perf 	perfect
perh 	perhaps
Periodontol 	periodontology
pers 	person
Pers 	Persian
Pers 	personal
Persec 	persecution
personif 	personified
Perthsh 	Perthshire
Pet 	 Peter
Petrogr 	petrography
Petrol 	petrology
pf 	perfect
Pharm 	pharmacology
Pharmaceut 	pharmaceutical
Pharmacol 	pharmacology
Phil 	philosophy
Phil 	 Philippians
Philad 	Philadelphia
Philem 	 Philemon
Philipp 	 Philippians
Philol 	philology
Philos 	philosophy
Phoen 	Phoenician
phonet 	phonetic
Phonol 	phonology
Photog 	photography
Photogr 	photography
phr 	phrase
Phrenol 	phrenology
Phys 	physiology
Physiogr 	physiography
Physiol 	physiology
Pict 	pictorial
Pict 	picture
pl 	plural
plur 	plural
poet 	poetic
Poet 	poetical
Pol 	politics
Polit 	politics
pop 	popular
Pop 	popular
Porc 	porcelain
Port 	Portuguese
poss 	possessive
poss 	possible
Posth 	posthumous
Postm 	postmaster
Pott 	pottery
ppl 	participial
pple 	participle
pples 	participles
P R 	public records
pr 	present
Pract 	practical
Pract 	practice
prec 	preceding
pred 	predicate
predic 	predicate
Predict 	prediction
pref 	prefix
Pref 	preface
Preh 	prehistoric
Prehist 	prehistory
prep 	preposition
Prerog 	prerogative
pres 	present
Pres 	present
Presb 	Presbyterian
Presb 	presbytery
Preserv 	preservation
pres pple 	present participle
Prim 	primer
Princ 	principle
Print 	printing
priv 	privative
prob 	probably
Probab 	probability
Probl 	problem
Proc 	proceedings
Prod 	product
Prol 	prologue
pron 	pronoun
pron 	pronunciation
pronunc 	pronunciation
Pronunc 	pronunciation
prop 	properly
Prop 	property
propr 	proprietary
Pros 	prosody
prov 	proverb
Prov 	proverb
Prov 	 Proverbs
Provid 	providence
Provinc 	provincial
Provis 	provisional
Ps 	 Psalms
pseudo-arch 	pseudo-archaic
pseudo-dial 	pseudo-dialect
pseudo-Sc 	pseudo-Scots
Psych 	psychology
Psychoanal 	psychoanalysis
Psychoanalyt 	psychoanalytic
Psychol 	psychology
Psychopathol 	psychopathology
Publ 	public
Publ 	publication
Purg 	purgatory
Qld 	Queensland
quot 	quotation
quots 	quotations
R 	royal
Radiol 	radiology
Reas 	reason
Reb 	rebellion
Rebell 	rebellion
Rec 	record
Reclam 	reclamation
Recoll 	recollection
Redempt 	redemption
redupl 	reduplicating
Ref 	reference
Ref 	reformation
refash 	refashioned
refl 	reflexive
Refl 	reflection
Refus 	refusal
Refut 	refutation
reg 	regular
Reg 	register
Regic 	regicide
Regist 	register
Regr 	register
rel 	related
rel 	relative
Rel 	relating
Relig 	religion
Reminisc 	reminiscence
Remonstr 	remonstrance
Renfrewsh 	Renfrewshire
Rep 	report
repr 	representative
Reprod 	reproduction
Rept 	report
Repub 	republic
Res 	research
Resid 	residence
Ret 	return
Retrosp 	retrospective
Rev 	review
Rev 	revised
Rev 	 Revelation
Revol 	revolution
Rhet 	rhetoric
rhet 	rhetorical
Rich 	Richard
RN 	Royal Navy
Rom 	Roman
Rom 	 Romans
Ross-sh 	Ross-shire
Roxb 	Roxburgh
Roy 	royal
Rudim 	rudiment
Russ 	Russia
Sam 	 Samuel
Sask 	Saskatchewan
Sat 	Saturday
Sax 	Saxon
Sc 	Scottish
Scand 	Scandinavia
Sch 	school
Sci 	science
Scot 	Scottish
Scotl 	Scotland
Script 	scripture
Sculpt 	sculpture
se 	south-eastern 
SE 	south-east
Seismol 	seismology
Sel 	selected
Sel comm 	select committee
Select 	selection
Sept 	September
Ser 	series
Serm 	sermon
Sess 	session
Settlem 	settlement
Sev 	several
Shakes 	Shakespeare
Shaks 	Shakespeare
Sheph 	shepherd
Shetl 	Shetland
Shropsh 	Shropshire
sing 	singular
Soc 	society
Sociol 	sociology
Som 	Somerset
Sonn 	sonnet
south 	southern 
sp 	spelling
Span 	Spanish
spec 	specifically
Spec 	special
Spec 	specimen
Specif 	specification
Specim 	specimen
Spectrosc 	spectroscopy
SS 	saints
St 	Saint
St 	street
Staff 	Staffordshire
Stafford 	Staffordshire
Staffordsh 	Staffordshire
Staffs 	Staffordshire
Stand 	standard
Stat 	statistical
Statist 	statistical
Stock Exch 	stock exchange
str 	strong
Stratigr 	stratigraphy
Struct 	structure
STS 	Scottish Text Society
Stud 	studies
subj 	subject
subj 	subjunctive
Subj 	subject
subjunct 	subjunctive
subord 	subordinate
subord cl 	subordinate clause
Subscr 	subscription
Subscript 	subscription
subseq 	subsequent
subst 	substantive
suff 	suffix
Suff 	Suffolk
superl 	superlative
Suppl 	supplement
Supplic 	supplication
Suppress 	suppression
Surg 	surgery
Surv 	survey
Sus 	 Susanna
sw 	south-western 
SW 	south-west
syll 	syllable
Symmetr 	symmetrical
Symp 	symposium
Syst 	system
t 	tense
Taxon 	taxonomy
techn 	technical
Techn 	technical
Technol 	technology
Tel 	telegraph
Telecomm 	telecommunications
Telegr 	telegraph
Telegr 	telegraphy
Teleph 	telephony
Teratol 	teratology
Terminol 	terminology
Terrestr 	terrestrial
Test 	testament
Textbk 	textbook
Theat 	theatre
Theatr 	theatre
Theol 	theology
Theoret 	theoretical
Thermonucl 	thermonuclear
Thes 	thesaurus
Thess 	 Thessalonians
Tim 	 Timothy
Tit 	 Titus
Topogr 	topography
tr 	translation
Trad 	tradition
Trag 	tragedy
trans 	transitive
Trans 	transaction
transf 	transferred sense
transl 	translation
Transl 	translation
Transubstant 	transubstantiation
Trav 	travel
Treas 	treasurer
Treat 	treatise
Treatm 	treatment
Trib 	tribune
Trig 	trigonometry
Trigonom 	trigonometry
Trop 	tropical
Troub 	troublesome
Troubl 	troublesome
Typog 	typography
Typogr 	typography
ult 	ultimately
Univ 	university
unkn 	unknown
Unnat 	unnatural
Unoffic 	unofficial
unstr 	unstressed
Urin 	urinary
usu 	usually
Utilit 	utilitarian
v 	verb
Va 	Virginia
Vac 	vacation
Valedict 	valediction
var 	variant
varr 	variants
vars 	variants
vb 	verb
vbl 	verbal
vbln 	verbal noun
vbl ns 	verbal nouns
vbs 	verbs
Veg 	vegetable
Venet 	Venetian
Vertebr 	vertebrate
Vet 	veterinary
Vic 	Victoria
Vict 	Victoria
Vind 	vindication
Vindic 	vindication
Virg 	virgin
Virol 	virology
Voc 	vocabulary
Vocab 	vocabulary
Vol 	volume
Vols 	volumes
Voy 	voyage
vulg 	vulgar
Vulg 	vulgar
Vulg 	Vulgate
Warwicksh 	Warwickshire
wd 	word
Wd 	word
west 	western
Westm 	Westminster
Westmld 	Westmoreland
Westmorld 	Westmoreland
Westmrld 	Westmoreland
Will 	William
Wilts 	Wiltshire
Wiltsh 	Wiltshire
W Ind 	West Indies
W Indies 	West Indies
Wis 	Wisconsin
Wisd 	wisdom
Wisd 	 Wisdom of Solomon
wk 	weak
Wk 	week
Wk 	work
Wkly 	weekly
Wks 	works
Wonderf 	wonderful
Worc 	Worcestershire
Worcestersh 	Worcestershire
Worcs 	Worcestershire
Writ 	writing
W Va 	West Virginia
Yearbk 	yearbook
Yng 	young
Yorks 	Yorkshire
Yorksh 	Yorkshire
Yr 	year
Yrs 	years
Zech 	 Zechariah
Zeitschr 	Zeitschrift
Zeph 	 Zephaniah
Zoogeogr 	zoogeography
Zool 	zoology
